%BASISPACKAGEPREFIX%WITHOUTDOTOOOBASEVERSION-%LANGUAGESTRING	Language module for %APACHEPROJECTNAME %OOOBASEVERSION, language %LANGUAGESTRING
%BASISPACKAGEPREFIX%WITHOUTDOTOOOBASEVERSION-%LANGUAGESTRING-base	Base language module for %APACHEPROJECTNAME %OOOBASEVERSION, language %LANGUAGESTRING
%BASISPACKAGEPREFIX%WITHOUTDOTOOOBASEVERSION-%LANGUAGESTRING-calc	Calc language module for %APACHEPROJECTNAME %OOOBASEVERSION, language %LANGUAGESTRING
%BASISPACKAGEPREFIX%WITHOUTDOTOOOBASEVERSION-%LANGUAGESTRING-draw	Draw language module for %APACHEPROJECTNAME %OOOBASEVERSION, language %LANGUAGESTRING
%BASISPACKAGEPREFIX%WITHOUTDOTOOOBASEVERSION-%LANGUAGESTRING-fonts	Language fonts module for %APACHEPROJECTNAME %OOOBASEVERSION, language %LANGUAGESTRING
%BASISPACKAGEPREFIX%WITHOUTDOTOOOBASEVERSION-%LANGUAGESTRING-help	Language help module for %APACHEPROJECTNAME %OOOBASEVERSION, language %LANGUAGESTRING
%BASISPACKAGEPREFIX%WITHOUTDOTOOOBASEVERSION-%LANGUAGESTRING-impress	Impress language module for %APACHEPROJECTNAME %OOOBASEVERSION, language %LANGUAGESTRING
%BASISPACKAGEPREFIX%WITHOUTDOTOOOBASEVERSION-%LANGUAGESTRING-math	Math language module for %APACHEPROJECTNAME %OOOBASEVERSION, language %LANGUAGESTRING
%BASISPACKAGEPREFIX%WITHOUTDOTOOOBASEVERSION-%LANGUAGESTRING-onlineupd	Online update language module for %APACHEPROJECTNAME %OOOBASEVERSION, language %LANGUAGESTRING
%BASISPACKAGEPREFIX%WITHOUTDOTOOOBASEVERSION-%LANGUAGESTRING-res	Language resource module for %APACHEPROJECTNAME %OOOBASEVERSION, language %LANGUAGESTRING
%BASISPACKAGEPREFIX%WITHOUTDOTOOOBASEVERSION-%LANGUAGESTRING-writer	Writer language module for %APACHEPROJECTNAME %OOOBASEVERSION, language %LANGUAGESTRING
%BASISPACKAGEPREFIX%WITHOUTDOTOOOBASEVERSION-activex	ActiveX control for %APACHEPROJECTNAME %OOOBASEVERSION
%BASISPACKAGEPREFIX%WITHOUTDOTOOOBASEVERSION-base	Base module for %APACHEPROJECTNAME%OOOBASEVERSION
%BASISPACKAGEPREFIX%WITHOUTDOTOOOBASEVERSION-calc	Calc module for %APACHEPROJECTNAME %OOOBASEVERSION
%BASISPACKAGEPREFIX%WITHOUTDOTOOOBASEVERSION-core01	Core module for %APACHEPROJECTNAME %OOOBASEVERSION
%BASISPACKAGEPREFIX%WITHOUTDOTOOOBASEVERSION-core02	Office core module for %APACHEPROJECTNAME %OOOBASEVERSION
%BASISPACKAGEPREFIX%WITHOUTDOTOOOBASEVERSION-core03	Office core module for %APACHEPROJECTNAME %OOOBASEVERSION
%BASISPACKAGEPREFIX%WITHOUTDOTOOOBASEVERSION-core04	Office core module for %APACHEPROJECTNAME %OOOBASEVERSION
%BASISPACKAGEPREFIX%WITHOUTDOTOOOBASEVERSION-core05	Office core module for %APACHEPROJECTNAME %OOOBASEVERSION
%BASISPACKAGEPREFIX%WITHOUTDOTOOOBASEVERSION-core06	Office core module for %APACHEPROJECTNAME %OOOBASEVERSION
%BASISPACKAGEPREFIX%WITHOUTDOTOOOBASEVERSION-core07	Office core module for %APACHEPROJECTNAME %OOOBASEVERSION
%BASISPACKAGEPREFIX%WITHOUTDOTOOOBASEVERSION-dict-gl	Gl dictionary for %PRODUCTNAME %PRODUCTVERSION
%BASISPACKAGEPREFIX%WITHOUTDOTOOOBASEVERSION-dict-vi	Vietnamese dictionary for %PRODUCTNAME %PRODUCTVERSION
%BASISPACKAGEPREFIX%WITHOUTDOTOOOBASEVERSION-draw	Draw module for %APACHEPROJECTNAME %OOOBASEVERSION
%BASISPACKAGEPREFIX%WITHOUTDOTOOOBASEVERSION-emailmerge	Email mailmerge module for %APACHEPROJECTNAME %OOOBASEVERSION
%BASISPACKAGEPREFIX%WITHOUTDOTOOOBASEVERSION-gnome-integratn	Gnome integration module for %APACHEPROJECTNAME %OOOBASEVERSION
%BASISPACKAGEPREFIX%WITHOUTDOTOOOBASEVERSION-graphicfilter	Graphic filter module for %APACHEPROJECTNAME %OOOBASEVERSION
%BASISPACKAGEPREFIX%WITHOUTDOTOOOBASEVERSION-headless	Headless display module for %APACHEPROJECTNAME %OOOBASEVERSION
%BASISPACKAGEPREFIX%WITHOUTDOTOOOBASEVERSION-images	Images module for %APACHEPROJECTNAME %OOOBASEVERSION
%BASISPACKAGEPREFIX%WITHOUTDOTOOOBASEVERSION-impress	Impress module for %APACHEPROJECTNAME %OOOBASEVERSION
%BASISPACKAGEPREFIX%WITHOUTDOTOOOBASEVERSION-javafilter	Java filter module for %APACHEPROJECTNAME %OOOBASEVERSION
%BASISPACKAGEPREFIX%WITHOUTDOTOOOBASEVERSION-kde-integration	KDE integration module for %APACHEPROJECTNAME %OOOBASEVERSION
%BASISPACKAGEPREFIX%WITHOUTDOTOOOBASEVERSION-math	Math module for %APACHEPROJECTNAME %OOOBASEVERSION
%BASISPACKAGEPREFIX%WITHOUTDOTOOOBASEVERSION-onlineupdate	Online update modul for %APACHEPROJECTNAME %OOOBASEVERSION
%BASISPACKAGEPREFIX%WITHOUTDOTOOOBASEVERSION-ooofonts	Mailcap module for %APACHEPROJECTNAME %OOOBASEVERSION
%BASISPACKAGEPREFIX%WITHOUTDOTOOOBASEVERSION-ooolinguistic	Linguistic module for %APACHEPROJECTNAME %OOOBASEVERSION
%BASISPACKAGEPREFIX%WITHOUTDOTOOOBASEVERSION-pyuno	Pyuno module for %APACHEPROJECTNAME %OOOBASEVERSION
%BASISPACKAGEPREFIX%WITHOUTDOTOOOBASEVERSION-spellcheck	English spellchecker module for %APACHEPROJECTNAME %OOOBASEVERSION
%BASISPACKAGEPREFIX%WITHOUTDOTOOOBASEVERSION-testtool	Testtool module for %APACHEPROJECTNAME %OOOBASEVERSION
%BASISPACKAGEPREFIX%WITHOUTDOTOOOBASEVERSION-writer	Writer module for %APACHEPROJECTNAME %OOOBASEVERSION
%BASISPACKAGEPREFIX%WITHOUTDOTOOOBASEVERSION-xsltfilter	XSLT filter samples module for %APACHEPROJECTNAME %OOOBASEVERSION
%PACKAGEPREFIX%SOLARISBRANDPACKAGENAME%BRANDPACKAGEVERSION-dict-af	Af dictionary for %PRODUCTNAME %PRODUCTVERSION
%PACKAGEPREFIX%SOLARISBRANDPACKAGENAME%BRANDPACKAGEVERSION-dict-cs	Cs dictionary for %PRODUCTNAME %PRODUCTVERSION
%PACKAGEPREFIX%SOLARISBRANDPACKAGENAME%BRANDPACKAGEVERSION-dict-da	Da dictionary for %PRODUCTNAME %PRODUCTVERSION
%PACKAGEPREFIX%SOLARISBRANDPACKAGENAME%BRANDPACKAGEVERSION-dict-de	De dictionary for %PRODUCTNAME %PRODUCTVERSION
%PACKAGEPREFIX%SOLARISBRANDPACKAGENAME%BRANDPACKAGEVERSION-dict-en	En dictionary for %PRODUCTNAME %PRODUCTVERSION
%PACKAGEPREFIX%SOLARISBRANDPACKAGENAME%BRANDPACKAGEVERSION-dict-es	Es dictionary for %PRODUCTNAME %PRODUCTVERSION
%PACKAGEPREFIX%SOLARISBRANDPACKAGENAME%BRANDPACKAGEVERSION-dict-et	Et dictionary for %PRODUCTNAME %PRODUCTVERSION
%PACKAGEPREFIX%SOLARISBRANDPACKAGENAME%BRANDPACKAGEVERSION-dict-fr	Fr dictionary for %PRODUCTNAME %PRODUCTVERSION
%PACKAGEPREFIX%SOLARISBRANDPACKAGENAME%BRANDPACKAGEVERSION-dict-hu	Hu dictionary for %PRODUCTNAME %PRODUCTVERSION
%PACKAGEPREFIX%SOLARISBRANDPACKAGENAME%BRANDPACKAGEVERSION-dict-it	It dictionary for %PRODUCTNAME %PRODUCTVERSION
%PACKAGEPREFIX%SOLARISBRANDPACKAGENAME%BRANDPACKAGEVERSION-dict-lt	Lt dictionary for %PRODUCTNAME %PRODUCTVERSION
%PACKAGEPREFIX%SOLARISBRANDPACKAGENAME%BRANDPACKAGEVERSION-dict-ne	Ne dictionary for %PRODUCTNAME %PRODUCTVERSION
%PACKAGEPREFIX%SOLARISBRANDPACKAGENAME%BRANDPACKAGEVERSION-dict-nl	Nl dictionary for %PRODUCTNAME %PRODUCTVERSION
%PACKAGEPREFIX%SOLARISBRANDPACKAGENAME%BRANDPACKAGEVERSION-dict-pl	Pl dictionary for %PRODUCTNAME %PRODUCTVERSION
%PACKAGEPREFIX%SOLARISBRANDPACKAGENAME%BRANDPACKAGEVERSION-dict-pt	Pt dictionary for %PRODUCTNAME %PRODUCTVERSION
%PACKAGEPREFIX%SOLARISBRANDPACKAGENAME%BRANDPACKAGEVERSION-dict-ru	Ru dictionary for %PRODUCTNAME %PRODUCTVERSION
%PACKAGEPREFIX%SOLARISBRANDPACKAGENAME%BRANDPACKAGEVERSION-dict-sk	Sk dictionary for %PRODUCTNAME %PRODUCTVERSION
%PACKAGEPREFIX%SOLARISBRANDPACKAGENAME%BRANDPACKAGEVERSION-dict-sl	Sl dictionary for %PRODUCTNAME %PRODUCTVERSION
%PACKAGEPREFIX%SOLARISBRANDPACKAGENAME%BRANDPACKAGEVERSION-dict-sv	Sv dictionary for %PRODUCTNAME %PRODUCTVERSION
%PACKAGEPREFIX%SOLARISBRANDPACKAGENAME%BRANDPACKAGEVERSION-dict-sw	Sw dictionary for %PRODUCTNAME %PRODUCTVERSION
%PACKAGEPREFIX%SOLARISBRANDPACKAGENAME%BRANDPACKAGEVERSION-dict-th	Th dictionary for %PRODUCTNAME %PRODUCTVERSION
%PACKAGEPREFIX%SOLARISBRANDPACKAGENAME%BRANDPACKAGEVERSION-dict-zu	Zu dictionary for %PRODUCTNAME %PRODUCTVERSION
%WITHOUTDOTUNIXPACKAGENAME%BRANDPACKAGEVERSION	Brand module for %PRODUCTNAME %PRODUCTVERSION
%WITHOUTDOTUNIXPACKAGENAME%BRANDPACKAGEVERSION-%LANGUAGESTRING	Brand language module for %PRODUCTNAME %PRODUCTVERSION
%WITHOUTDOTUNIXPACKAGENAME%BRANDPACKAGEVERSION-base	Base brand module for %PRODUCTNAME %PRODUCTVERSION
%WITHOUTDOTUNIXPACKAGENAME%BRANDPACKAGEVERSION-calc	Calc brand module for %PRODUCTNAME %PRODUCTVERSION
%WITHOUTDOTUNIXPACKAGENAME%BRANDPACKAGEVERSION-draw	Draw brand module for %PRODUCTNAME %PRODUCTVERSION
%WITHOUTDOTUNIXPACKAGENAME%BRANDPACKAGEVERSION-impress	Impress brand module for %PRODUCTNAME %PRODUCTVERSION
%WITHOUTDOTUNIXPACKAGENAME%BRANDPACKAGEVERSION-math	Math brand module for %PRODUCTNAME %PRODUCTVERSION
%WITHOUTDOTUNIXPACKAGENAME%BRANDPACKAGEVERSION-writer	Writer brand module for %PRODUCTNAME %PRODUCTVERSION
